0 5 0 5 0
0 6 0 6 2
2 0 0 0 2
1 0 0 0 0
0 0 0 0 0