0 0 0 0 2
0 0 2 5 1
0 0 2 6 0
0 0 0 3 4
0 0 0 0 0