0 0 0 1 2
3 4 0 0 0
0 0 0 2 0
0 5 0 0 0
0 6 2 0 0