0 0 0 2 0
0 2 1 3 4
0 0 2 0 0
0 0 0 0 0
0 0 0 0 0