0 1 0 0 0
0 0 0 0 0
2 0 2 0 0
0 5 2 0 0
2 6 0 0 0