0 0 0 0 0
0 0 3 4 0
0 0 0 0 1
1 0 1 5 0
0 0 0 6 0